NO textures/collectible.xpm
SO textures/escape.xpm
WE textures/floor.xpm

F 50,175,95
EA textures/player.xpm



C 25,90,110

111111111111111111111111111111111111111111111111111111111
100000000000000010000000000000000000000000010000000000001
100000000000000000000000000000000000000000010000000000001
11111111111111111000000000000E000000000000000000000000001
100000000000000000000000000000000000000000011111111111111
100000011000000000001111111111011111111110000000000000001
100000011000000000001000000000000000000010000011100000001
100000011111100000001000000000000000000010000010100000001
100000000000000000001000000000000000000010000011100000001
111111111111111100001000000000000000000010000000000000001
100000000000000100001000000000000000000010000000000000001
100000000000000100001111111111111111111110000000000000001
100000000000000000000000000000000000000000000000000000001
111111111111111111111111111111111111111111111111111111111
