NO ./textures/sara1so.xpm
SO ./textures/dario1no.xpm
WE ./textures/sara2we.xpm

EA ./textures/dario2ea.xpm

F 70,67,200
C 10,33,150

        1111111111111111111111111
        1000000000110000000000001
        1011000001110000000000001
        1001000000000000000000001
111111111011000001110000000000001
100000000011000001110111111111111
1111000000000000011100000011
1111000000000001111010011111
11000000110101011100000000001
10000000000000001100000W00001
10000000000000000001010000001
11000001110101011111011110111
11110111 1110101 101111010001
11111111 1111111 111111111111



