NO ./textures/dario1no.xpm
SO ./textures/sara1so.xpm
WE ./textures/sara2we.xpm

F 50,175,95
EA ./textures/dario2ea.xpm



C 25,90,110

        	1111111111111111111111111
        1000000000110000000000001
        1011000001110000000000001
        1001000000000000000000001
111111111011000001110000000000001
100000000011000001110111111111111
11110111111111011100000010001
111101111111110111     01010011111
11000000110101011100000010001
10000000000000001100000010001
10000000000000001101010010001
11000001110101011111011110W00111
11110111 1110101 101111010001
11111111 1111111 111111111111



